R 1600 800
NO ./textures/redbrick.xpm       
SO ./textures/bluestone.xpm     
WE ./textures/purplestone.xpm   
EA ./textures/greystone.xpm    
S ./textures/barrel.xpm   

F 31,117,254
C 159,129,112


1111111111111111111111111111111111111111111111111111111111111111
1000000000000000000000000000000000000000000000000000000000000001
1022222222222222222222222222220220222222222222222222222222222201
1022222222222222222222222222220220222222222222222222222222222201
1022222222222222222222222222220220222222222222222222222222222201
1022222222222222222222222222220220222222222222222222222222222201
1022222222222222222222222222220220222222222222222222222222222201
1022222222222222222222222222220220222222222222222222222222222201
1022222222222222222222222222220220222222222222222222222222222201
1022222222222222222222222222220220222222222222222222222222222201
1022222222222222222222222222220220222222222222222222222222222201
1022222222222222222222222222220220222222222222222222222222222201
1022222222222222222222222222220220222222222222222222222222222201
1022222222222222222222222222220220222222222222222222222222222201
1022222222222222222222222222220220222222222222222222222222222201
1022222222222222222222222222220220222222222222222222222222222201
1022222222222222222222222222220220222222222222222222222222222201
1022222222222222222222222222220220222222222222222222222222222201
1022222222222222222222222222220220222222222222222222222222222201
1022222222222222222222222222220220222222222222222222222222222201
1022222222222222222222222222220220222222222222222222222222222201
1022222222222222222222222222220220222222222222222222222222222201
1022222222222222222222222222220220222222222222222222222222222201
1022222222222222222222222222220220222222222222222222222222222201
1022222222222222222222222222220220222222222222222222222222222201
1022222222222222222222222222220220222222222222222222222222222201
1022222222222222222222222222220220222222222222222222222222222201
1022222222222222222222222222220220222222222222222222222222222201
1022222222222222222222222222220220222222222222222222222222222201
1022222222222222222222222222220220222222222222222222222222222201
1022222222222002222222222222220111111111111111111111111111111111
10222222222220022222222222222201
10222222222220022222222222222201
10222222222220022222222222222201
10222222222220022222222222222201
10222222222220022222222222222201
10222222222220022222222222222201
10222222222220022222222222222201
10222222222220022222222222222201
10222222222220022222222222222201
10222222222220022222222222222201
10222222222220022222222222222201
10222222222220022222222222222201
10222222222220022222222222222201
10222222222220022222222222222201
10222222222220022222222222222201
10222222222220022222222222222201
10222222222220022222222222222201
10222222222220022222222222222201
10222222222220022222222222222201
10222222222220022222222222222201
10222222222220022222222222222201
10222222222220022222222222222201
10222222222220022222222222222201
10222222222220022222222222222201
10222222222220022222222222222201
10222222222220022222222222222201
10222222222220022222222222222201
10222222222220022222222222222201
10222222222220022222222222222201
10222222222220022222222222222201
10222222222220022222222222222201
10222222222220022222222222222201
10222222222220022222222222222201
10222222222220022222222222222201
10222222222220022222222222222201
10222222222220022222222222222201
10222222222220022222222222222201
10222222222220022222222222222201
10222222222220022222222222222201
10222222222220022222222222222201
10222222222220022222222222222201
10222222222220022222222222222201
10222222222220022222222222222201    
10000000000000000000000000000001
10222222222220022222222222222201
10222222222220022222222222222201
10222222222220022222222222222201
10222222222220022222222222222201
10222222222220022222222222222201
10222222222220022222222222222201
10000000000000000000000000000001
1111111111110000011111111111111111111
11111111111100000111111111111111          11111
111111111111000001111111111111111111 1111111111
111111111111000001111111111111111111 111100001
11111111111100N001111111111111111111 1111111111
11111111111111111111111111111111
