R 1200 800
NO ./textures/tex1.xpm

SO ./textures/tex2.xpm 
WE ./textures/redbrick.xpm 
EA ./textures/greystone.xpm     
S ./textures/barrel.xpm

F 31,117,254
C 159,129,112

111 1111  11111111111111
101 1001  10000000000001
101110011110000000000001
100000000000000000000001
100000111110000000010001
100000100010000000000001
100000100010000000010001
100000100010000000000001
100000110110000000010001
100000000000000000000001
1000000000000000S0000001
100000000000000000000001
100000000000000000000001
100000000000000000000001
100000000000000000000001
100000000000000000000001
111111111000000000000001
110100001000000002000001
110000101000000000000001
110100001000000002000001
110111111000000000000001
110000000000000000000001
111111111000000000000001
111111111111111111111111